에서도	Josa
하지만	Conjunction
그리고	Conjunction
어디서	Adverb
일텐데	Josa
이지만	Josa
보다는	Josa
우연히	Adverb
이어서	Josa
만으로도	Josa
으로는	Josa
그래도	Adverb
그렇게	Adverb
보다도	Josa
부터가	Josa
하고는	Josa
아무리	Adverb
골고루	Adverb
으로도	Josa
이라니	Josa
하다못해	Adverb
이에요	Josa
이렇게	Adverb
이라는	Josa
너무나	Adverb
아무튼	Adverb
이래서	Josa
그만큼	Adverb
아직도	Adverb
그나마	Adverb
오래도록	Adverb
이니까	Josa
계속계속	Adverb
에서는	Josa
아주아주	Adverb
에게는	Josa
그래서	Adverb
너무나도	Adverb
만으로	Josa
오래전	Adverb
까지는	Josa
키득키득	Adverb
무지무지	Adverb
그렇지만	Conjunction
부터의	Josa
너무도	Adverb
언제나	Adverb
이라고	Josa
까지도	Josa
저렇게	Adverb
그러나	Conjunction
정말로	Adverb
마다의	Josa
치고는	Josa
아낌없이	Adverb
스러운	Josa
지극히	Adverb
오래간만	Adverb
랄랄라	Adverb
이라서	Josa
간간히	Adverb
그나저나	Adverb
에서와	Josa
두근두근	Adverb
오랫동안	Adverb
마저도	Josa
에게와	Josa
에게도	Josa
서슴없이	Adverb
에다가	Josa
그렇다고	Conjunction
만큼의	Josa
이자나	Josa
에서의	Josa
으로만	Josa
스럽지	Josa
누군지	Adverb
나긋나긋	Adverb
그런데	Conjunction
깜짝깜짝	Adverb
말랑말랑	Adverb
똑같이	Adverb
인가요	Josa
깨작깨작	Adverb
하여금	Adverb
라니까	Josa
이라도	Josa
해마다	Adverb
스럽게	Josa
하여간	Adverb
이라고는	Josa
열심히	Adverb
에게서	Josa
기꺼이	Adverb
부터는	Josa
만으로는	Josa
이대로	Adverb
한동안	Adverb
에서나	Josa
적어도	Adverb
이구나	Josa
이기도	Josa
가물가물	Adverb
의외로	Adverb
드디어	Adverb
까지나	Josa
아마도	Adverb
라기보다는	Josa
으로써	Josa
우루루	Adverb
주륵주륵	Adverb
가만히	Adverb
그러면	Adverb
틀림없이	Adverb
언젠가	Adverb
쓸데없이	Adverb
그랬는데	Conjunction
으로부터	Josa
만큼은	Josa
이나마	Josa
꺼이꺼이	Adverb
천천히	Adverb
퐁당퐁당	Adverb
허우적허우적	Adverb
음하하	Exclamation
에게다	Josa
하나같이	Adverb
그야말로	Adverb
으로의	Josa
이구만	Josa
에서만	Josa
어쩌나	Adverb
수없이	Adverb
이랬는데	Conjunction
그러니까	Adverb
정신없이	Adverb
어쩌다	Adverb
화들짝	Adverb
들썩들썩	Adverb
왜냐하면	Adverb
어찌나	Adverb
으로서	Josa
부터라도	Josa
으로가	Josa
오글오글	Adverb
그럭저럭	Adverb
울컥울컥	Adverb
만큼이나	Josa
야말로	Josa
어김없이	Adverb
말고는	Josa
이야말로	Josa
으로라도	Josa
으허헝	Adverb
하고도	Josa
그러다가	Conjunction
으으윽	Adverb
그토록	Adverb
첨으로	Adverb
조곤조곤	Adverb
만큼이라도	Josa
밖에는	Josa
까지가	Josa
자연스레	Adverb
에서까지	Josa
한없이	Adverb
그러므로	Conjunction
살짝살짝	Adverb
어정쩡	Adverb
끝없이	Adverb
빙글빙글	Adverb
까지의	Josa
에서야	Josa
으로서의	Josa
마니마니	Adverb
아무래도	Adverb
그렁그렁	Adverb
조금씩	Adverb
에서라도	Josa
하염없이	Adverb
이라기	Josa
누굴까	Adverb
에서가	Josa
콩당콩당	Adverb
이따금	Adverb
에서부터	Josa
만이라도	Josa
오랜만	Adverb
우후후	Adverb
까지만	Josa
기우뚱	Adverb
흐어어	Exclamation
움찔움찔	Adverb
으로선	Josa
아이고	Exclamation
대로의	Josa
에까지	Josa
또다시	Adverb
으로까지	Josa
에게나	Josa
라던가	Josa
하고만	Josa
으로나	Josa
그러기에	Conjunction
라고는	Josa
능청능청	Adverb
에게만	Josa
반짝반짝	Adverb
호빗호빗	Adverb
이랑은	Josa
이거지	Adverb
일부일	Adverb
이라곤	Josa
자주자주	Adverb
굽신굽신	Adverb
조차도	Josa
수시로	Adverb
이리저리	Adverb
까지와	Josa
말고도	Josa
라든지	Josa
오로지	Adverb
설마설마	Adverb
어렴풋이	Adverb
뜬금없이	Adverb
오호호	Adverb
에라도	Josa
드르륵	Adverb
빙긋이	Adverb
시끌벅적	Adverb
매시간	Adverb
그런대로	Adverb
어짜피	Adverb
대놓고	Adverb
감사히	Adverb
유난히	Adverb
라고만은	Josa
으로서도	Josa
이라기보다는	Josa
주루룩	Adverb
후후훗	Exclamation
맙소사	Exclamation
울고불고	Adverb
처럼만	Josa
이오니	Josa
쓸모없이	Adverb
에게까지	Josa
으로서는	Josa
이라고도	Josa
이래저래	Adverb
이러니	Conjunction
마따나	Josa
한결같이	Adverb
찌릿찌릿	Adverb
에서처럼	Josa
때때로	Adverb
하마터면	Adverb
벌떡벌떡	Adverb
이를테면	Adverb
남몰래	Adverb
이러쿵저러쿵	Adverb
로구나	Josa
하기야	Adverb
로군요	Josa
아리까리	Adverb
만큼만	Josa
라니깐	Josa
기신기신	Adverb
듬성듬성	Adverb
보다야	Josa
부글부글	Adverb
만지작	Adverb
아른아른	Adverb
어이없이	Adverb
와장창	Adverb
진실로	Adverb
바로바로	Adverb
라기보단	Josa
이러니까	Conjunction
아이구	Exclamation
한가득	Adverb
맘대로	Adverb
어떻든	Adverb
까지라도	Josa
펄떡펄떡	Adverb
다각도로	Adverb
라든가	Josa
서로서로	Adverb
에게라도	Josa
북실북실	Adverb
드문드문	Adverb
우어어	Exclamation
자랑스레	Adverb
인가가	Josa
살며시	Adverb
으아아	Exclamation
이래도	Josa
자꾸자꾸	Adverb
부터도	Josa
껑충껑충	Adverb
관계없이	Adverb
아이참	Exclamation
그니까	Conjunction
어물쩍	Adverb
그랬다고	Conjunction
이라든지	Josa
이맘때	Adverb
주저리주저리	Adverb
간질간질	Adverb
부그그	Adverb
술렁술렁	Adverb
급기야	Adverb
야금야금	Adverb
처럼은	Josa
이러케	Adverb
덜컹덜컹	Adverb
울퉁불퉁	Adverb
꾸역꾸역	Adverb
몰랑몰랑	Adverb
이히히	Adverb
개골개골	Adverb
귀뚤귀뚤	Adverb
에서보다	Josa
으로서가	Josa
번쩍번쩍	Adverb
또랑또랑	Adverb
까지를	Josa
하기는	Adverb
풍덩풍덩	Adverb
에로의	Josa
에서조차	Josa
사정없이	Adverb
이하고	Josa
까불까불	Adverb
나지막이	Adverb
외로이	Adverb
에서나마	Josa
떡하니	Adverb
몰캉몰캉	Adverb
그제야	Adverb
이라기보단	Josa
에그머니	Exclamation
아직껏	Adverb
스르륵	Adverb
으로써는	Josa
뜻대로	Adverb
곤드레	Adverb
자연히	Adverb
만으론	Josa
하루빨리	Adverb
무시무시	Adverb
라지요	Josa
능글능글	Adverb
에게로	Josa
일수록	Josa
콩닥콩닥	Adverb
득실득실	Adverb
오싹오싹	Adverb
어리어리	Adverb
스멀스멀	Adverb
어쩌라고	Adverb
에게가	Josa
눈누난나	Adverb
라고까지	Josa
시원시원	Adverb
우오오	Exclamation
로서나	Josa
깊숙이	Adverb
빈번히	Adverb
고독고독	Adverb
으어어	Exclamation
으으응	Adverb
가득가득	Adverb
스럽지도	Josa
도란도란	Adverb
까지만이라도	Josa
그리하여	Conjunction
이신가	Josa
마구마구	Adverb
왁자지껄	Adverb
언뜻언뜻	Adverb
재빨리	Adverb
꾸벅꾸벅	Adverb
여하간	Adverb
짜릿짜릿	Adverb
어쩌고저쩌고	Adverb
대로는	Josa
조물조물	Adverb
아하하	Adverb
열시미	Adverb
이른바	Adverb
에서와는	Josa
보들보들	Adverb
화끈화끈	Adverb
차르륵	Adverb
으로부터의	Josa
와아아	Exclamation
간신히	Adverb
아무렴	Exclamation
어리바리	Adverb
잘근잘근	Adverb
우르릉	Adverb
우짜노	Exclamation
촘촘히	Adverb
만큼도	Josa
가벼이	Adverb
저릿저릿	Adverb
어처구니없이	Adverb
에게서도	Josa
으흐흑	Adverb
처럼도	Josa
에게든	Josa
에게서는	Josa
히이이익	Exclamation
뽀송뽀송	Adverb
누군데	Adverb
부릉부릉	Adverb
같이만	Josa
나불나불	Adverb
이러다가	Adverb
엉성엉성	Adverb
깜빡깜빡	Adverb
끼적끼적	Adverb
할까말까	Adverb
은커녕	Josa
사각사각	Adverb
개시시	Adverb
아무쪼록	Adverb
버럭버럭	Adverb
는커녕	Josa
자유로이	Adverb
에조차도	Josa
어버버	Adverb
까지야	Josa
제데로	Adverb
가급적	Adverb
으로만은	Josa
까지에	Josa
이로써	Adverb
이같이	Adverb
대충대충	Adverb
으이구	Exclamation
쪼르르	Adverb
예컨대	Adverb
랑께요	Josa
어질어질	Adverb
이시고	Josa
오구구	Adverb
벌렁벌렁	Adverb
요렇게	Adverb
콩다콩	Adverb
에게야	Josa
억지스레	Adverb
가끔가다	Adverb
버둥버둥	Adverb
드르렁	Adverb
까딱까딱	Adverb
난데없이	Adverb
어허허	Adverb
덜렁덜렁	Adverb
버젓이	Adverb
어쨌건	Adverb
다름없이	Adverb
보다만	Josa
간당간당	Adverb
슬며시	Adverb
건들건들	Adverb
우중충	Adverb
너덜너덜	Adverb
우글우글	Adverb
그러나저러나	Adverb
갈까말까	Adverb
머뭇머뭇	Adverb
오호통재	Exclamation
넙죽넙죽	Adverb
쿠르릉	Adverb
설렁설렁	Adverb
모독이	Adverb
부터만	Josa
부진부진	Adverb
이든지	Josa
옹알옹알	Adverb
치렁치렁	Adverb
대로가	Josa
주절주절	Adverb
어영부영	Adverb
이지롱	Josa
간곡히	Adverb
어쩌지	Adverb
안절부절	Adverb
망실망실	Adverb
같이도	Josa
찰싹찰싹	Adverb
하고라도	Josa
에서만이	Josa
갉작갉작	Adverb
야드를	Adverb
밖에도	Josa
스스럼없이	Adverb
여보세요	Exclamation
그랬구나	Exclamation
갸우뚱	Adverb
아이코	Exclamation
하고야	Josa
자장자장	Adverb
우당탕	Adverb
울먹울먹	Adverb
찐득찐득	Adverb
하고의	Josa
우물우물	Adverb
구리구리	Adverb
하이고	Exclamation
그러자	Conjunction
어찌어찌	Adverb
파닥파닥	Adverb
느글느글	Adverb
드륵드륵	Adverb
결단코	Adverb
우걱우걱	Adverb
추적추적	Adverb
설마하니	Adverb
쌉쓰레	Adverb
푸드드	Adverb
이러나저러나	Adverb
보글보글	Adverb
니글니글	Adverb
아장아장	Adverb
그랬더니	Conjunction
께서는	Josa
아뿔싸	Exclamation
